##############
#..P.........#
#............#
#.........P..#
#............#
#.....P......#
##############