####################
#..P...........S...#
#..............S...#
#.........P....S...#
#..............S...#
#..............S...#
#..............S...#
#...P..........S...#
#..............S...#
#..............S...#
####################