####################
#..P...........SSSS#
#..............SSSS#
#.........P....SSSS#
#..............SSSS#
#..............SSSS#
#..............SSSS#
#...P..........SSSS#
#..............SSSS#
#..............SSSS#
####################